1111111111111
10010000000C1
1K00011111001
1P0011E0K0001
1111111111111
