111111111111111111111111
1E00000000000000000000K1
1PCCCCCCCCCCCCCCCCCC0001
111111111111111111111111
