11111111111111
10000000100001
100P000010E001
10000000100C01
10C00111100001
100011000C0001
100K000C000P01
100CCCCC000001
1000000000K001
11111111111111
