11111111111111
10000000100001
100P000010E001
10000000100001
10000111100001
10001100000001
10000000000001
10000000000001
10000000000001
11111111111111
